level_1 = (
"+------------------+"
"|        |         |"
"|--- +   | ---+    |"
"|    |        |    |"
"| +  +----+   |    |"
"| |        | 1|    |"
"| +---+    +--+    |"
"|     |            |"
"|-+   +------------|"
"|2|   |    +       |"
"| |   |    |       |"
"| |        |  +----|"
"| |        |       |"
"| +--------+--+    |"
"|             |    |"
"|     +----+  +    |"
"| 3   |            |"
"| +---|   +--------|"
"|     |           0|"
"+------------------+")
